1111111111111
1001000000001
1000011111001
100P110000001
10001000E0111
100010C000101
1111111111111