1111111111111111
1001000000000001
1000011111000001
1000110000000111
1000100000100001
1000000000000001
1111111111111111